T-T-T-T-T-T-T-T-T-T-T-T-T-T-T-T-T-T-T-T-T-T-T-T-T-T-T-T-T-T-T-T-T-T-T-T-
------------------------------------------------------------------------
T-********************************************************************T-
--********************************************************************--
T-**H-----**H-----**H-----**H-----**H-----**H-----**H-----**H-----****T-
--**-****-**-****-**-****-**-****-**-****-**-****-**-****-**-****-****--
T-**-****-**-****-**-****-**-****-**-****-**-****-**-****-**-****-****T-
--**--**--**--**--**--**--**--**--**--**--**--**--**--**--**--**--****--
T-********************************************************************T-
--*****************************************************vuuuuuuuux*****--
T-**H-----**H-----**H-----**H-----**H-----**H-----*****lwwwwwwwwr*****T-
--**-****-**-****-**-****-**-****-**-****-**-****-*****lwwwwwwwwr*****--
T-**-****-**-****-**-****-**-****-**-****-**-****-*****lwwwwwwwwr*****T-
--**--**--**--**--**--**--**--**--**--**--**--**--*****lwwwwwwwwr*****--
T-*****************************************************yddddddddz*****T-
--********************************************************************--
T-T-T-T-T-T-T-T-T-T-T-T-T-T-T-T-T-T-T-T-T-T-T-T-T-T-T-************T-T-T-
------------------------------------------------------************------
T-T-T-T-T-T-T-T-T-T-T-T-T-T-T-T-T-T-T-T-T-T-T-T-T-T-T-T-********T-T-T-T-
--------------------------------------------------------********--------
T-T-T-T-T-T-T-T-T-T-T-T-T-T-T-T-T-T-T-T-T-T-T-T-T-T-T-T-T-****T-T-T-T-T-
----------------------------------------------------------****----------
T-T-T-T-T-T-T-T-T-T-T-T-T-T-T-T-T-T-T-T-T-T-T-T-T-T-T-T-T-****T-T-T-T-T-
----------------------------------------------------------****----------
T-T-T-T-T-T-T-T-T-T-T-T-T-T-T-T-T-T-T-T-T-T-T-T-T-T-T-T-T-****T-T-T-T-T-
----------------------------------------------------------****----------
T-T-T-T-T-T-T-T-T-T-T-T-T-T-T-T-T-T-T-T-T-T-T-T-T-T-T-T-********T-T-T-T-
--------------------------------------------------------********--------
T-T-T-T-T-T-T-T-T-T-T-T-T-T-T-T-T-T-T-T-T-T-T-T-T-T-T-************T-T-T-
------------------------------------------------------************------
T-T-T-T-T-T-T-T-T-T-T-T-T-T-T-T-T-T-T-T-T-T-T-T-T-********************T-
--------------------------------------------------********************--
T-T-T-T-T-T-T-T-T-T-T-T-T-T-T-T-T-T-T-T-T-T-T-T-T-********************T-
--------------------------------------------------********************--
T-T-T-T-T-T-T-T-T-T-T-T-T-T-T-T-T-T-T-T-T-T-T-T-T-********************T-
--------------------------------------------------********************--
T-T-T-T-T-T-T-T-T-T-T-T-T-T-T-T-T-T-T-T-T-T-T-T-T-********************T-
--------------------------------------------------********************--
T-T-T-T-T-T-T-T-T-T-T-T-T-T-T-T-T-T-T-T-T-T-T-T-T-T-T-************T-T-T-
------------------------------------------------------************------
T-T-T-T-T-T-T-T-T-T-T-T-T-T-T-T-T-T-T-T-T-T-T-T-T-T-T-T-********T-T-T-T-
--------------------------------------------------------********--------
T-T-T-T-T-T-T-T-T-T-T-T-T-T-T-T-T-T-T-T-T-T-T-T-T-T-T-T-T-****T-T-T-T-T-
----------------------------------------------------------****----------
T-T-T-T-T-T-T-T-T-T-T-T-T-T-T-T-T-T-T-T-T-T-T-T-T-T-T-T-T-****T-T-T-T-T-
----------------------------------------------------------****----------
T-T-T-T-T-T-T-T-T-T-T-T-T-T-T-T-T-T-T-T-T-T-T-T-T-T-T-T-T-****T-T-T-T-T-
----------------------------------------------------------****----------
T-T-T-T-T-T-T-T-T-T-T-T-T-T-T-T-T-T-T-T-T-T-T-T-T-T-T-T-T-****T-T-T-T-T-
----------------------------------------------------------****----------
T-T-T-T-T-T-T-T-T-T-T-T-T-T-T-T-T-T-T-T-T-T-T-T-T-T-T-T-T-****T-T-T-T-T-
----------------------------------------------------------****----------
T-T-T-T-T-T-T-T-T-T-T-T-T-T-T-T-T-T-T-T-T-T-T-T-T-T-T-T-T-****T-T-T-T-T-
----------------------------------------------------------****----------
T-T-T-T-T-T-T-T-T-T-T-T-T-T-T-T-T-T-T-T-T-T-T-T-T-T-T-T-T-****T-T-T-T-T-
----------------------------------------------------------****----------
T-T-T-T-T-T-T-T-T-T-T-T-T-T-T-T-T-T-T-T-T-T-T-T-T-T-T-T-T-****T-T-T-T-T-
----------------------------------------------------------****----------
T-T-T-T-T-T-T-T-T-T-T-T-T-T-T-T-T-T-T-T-T-T-T-T-T-T-T-T-T-****T-T-T-T-T-
----------------------------------------------------------****----------
T-T-T-T-T-T-T-T-T-T-T-T-T-T-T-T-T-T-T-T-T-T-T-T-T-T-T-T-T-****T-T-T-T-T-
----------------------------------------------------------****----------
T-T-T-T-T-T-T-T-T-T-T-T-T-T-T-T-T-T-T-T-T-T-T-T-T-T-T-T-T-****T-T-T-T-T-
----------------------------------------------------------****----------
T-T-T-T-T-T-T-T-T-T-T-T-T-T-T-T-T-T-T-T-T-T-T-T-T-T-T-T-T-****T-T-T-T-T-
----------------------------------------------------------****----------
T-T-T-T-T-T-T-T-T-T-T-T-T-T-T-T-T-T-T-T-T-T-T-T-T-T-****************T-T-
----------------------------------------------------****************----
T-T-T-T-T-T-T-T-T-T-T-T-T-T-T-T-T-T-T-T-T-T-T-T-T-********************T-
--------------------------------------------------********************--
**********************************************************************T-
**********************************************************************--
**********************************************************************T-
**********************************************************************--
T-T-T-T-T-T-T-T-T-T-T-T-T-T-T-T-T-T-T-T-T-T-T-T-T-T-T-T-T-T-T-T-T-T-T-T-
------------------------------------------------------------------------