*************************
*************************
******S*****b*****S******
******S***********S******
******S***a*s*a***S******
******S***********S******
******S***********S******
******SSSSSSSSSSSSS******
*************************
*************************
*************************
***wwwwwww*****wwwwwww***
***wwwwwww*****wwwwwww***
***wwwwwww*****wwwwwww***
*************************
*************************
******G***G***G***G******
*************************
********8*******8********
*************************
******G***G***G***G******
*************************
********8***p***8********
*************************
*************************