--T-T-T-T-T-T-T-T-T-T-T-T-T-T-T-T-T-T-T-T-T-T-T-T-T-T-T-T-T-T-T-T-T-T---
------------------------------------------------------------------------
T-********************************************************************T-
--********************************************************************--
T-**H-----**H-----**H-----**H-----**H-----**H-----**H-----**H-----****T-
--**-****-**-****-**-c***-**-**c*-**-c***-**-**c*-**-****-**-****-****--
T-**-****-**-**c*-**-****-**-**?*-**-**#*-**-****-**-****-**-c#**-****T-
--**--**--**--**--**--#*--**--**--**--**--**--**--**--**--**--**--****--
T-***ga*g*******8**************************************8c*************T-
--********************************************************************--
T-**H-----**H-----**H-----**H-----**H-----**H-----******wwwwwwww******T-
--**-***c-**-****-**-**c*-**-****-**-****-**-****-******wwwwwwww******--
T-**-****-**-*c?*-**-****-**-*c#*-**-*c**-**-*c**-******wwwwwwww******T-
--**--**--**--**--**--**--**--**--**--**--**--**--******wwwwwwww******--
T-******8*************************************************************T-
--******************************************************g******g******--
--T-T-T-T-T-T-T-T-T-T-T-T-T-T-T-T-T-T-T-T-T-T-T-T-T-T-************T-T---
------------------------------------------------------************------
------------------------------------------------------T-********T-------
--------------------------------------------------------********--------
--------------------------------------------------------T-****T---------
----------------------------------------------------------****----------
--------------------------------------------------------T-****T---------
----------------------------------------------------------****----------
--------------------------------------------------------T-****T---------
----------------------------------------------------------****----------
------------------------------------------------------T-********T-------
--------------------------------------------------------********--------
--------------------------------------------------T-T-************T-T---
------------------------------------------------------************------
------------------------------------------------T-********************T-
--------------------------------------------------********************--
------------------------------------------------T-******c******c******T-
--------------------------------------------------******#******#******--
------------------------------------------------T-********************T-
--------------------------------------------------********************--
------------------------------------------------T-********************T-
--------------------------------------------------********************--
--------------------------------------------------T-T-************T-T---
------------------------------------------------------************------
------------------------------------------------------T-********T-------
--------------------------------------------------------********--------
--------------------------------------------------------T-****T---------
----------------------------------------------------------****----------
--------------------------------------------------------T-****T---------
----------------------------------------------------------****----------
--------------------------------------------------------T-****T---------
----------------------------------------------------------****----------
--------------------------------------------------------T-****T---------
----------------------------------------------------------****----------
--------------------------------------------------------T-****T---------
----------------------------------------------------------****----------
--------------------------------------------------------T-****T---------
----------------------------------------------------------****----------
--------------------------------------------------------T-****T---------
----------------------------------------------------------****----------
--------------------------------------------------------T-****T---------
----------------------------------------------------------****----------
--------------------------------------------------------T-****T---------
----------------------------------------------------------****----------
--------------------------------------------------------T-****T---------
----------------------------------------------------------****----------
--------------------------------------------------------T-****T---------
----------------------------------------------------------|~~~----------
----------------------------------------------------T-T-T-~~~~T-T-T-----
----------------------------------------------------------~~~~----------
--------------------------------------------------T-****************T---
----------------------------------------------------**********?*****----
T-T-T-T-T-T-T-T-T-T-T-T-T-T-T-T-T-T-T-T-T-T-T-T-T-********************T-
--------------------------------------------------********************--
**********************************************************************T-
*******************************************************G**G**G**G*****--
**p*******************************************************************T-
**********************************************************************--
T-T-T-T-T-T-T-T-T-T-T-T-T-T-T-T-T-T-T-T-T-T-T-T-T-T-T-T-T-T-T-T-T-T-T---
------------------------------------------------------------------------