-----------------------------------------------------------------------------------------------T-T-Q---------------T-T-T-T-T-T-T-T
-----LWWWWWWWWWWWWWWWWWWWWWWWWWWWWWWWWWWWWWWWWWWWWWWWWWWWWWWWWWWWWWWWWWWWWWWWWWWWWWWWWWWWWWWWWR-----------------------------------
----U---T--------------------------T---------S------------------------------------B------------T-T-----------------T-T-T-T-T-T-T-T
----M-----------------------------------S------------lwwwwwwwwr-------------------------T-------------****--****------------------
----M--LWWWWWR---**************----------------------lwwwwwwwwr--------*****---B---------------T-T----****--****---T-T-T-T-T-T-T-T
----M-M-S--------********####******************------lwwwwwwwwr--------*****------LWWWWWWWWWWWR-------**********------------------
--T-M-M----------*****########################*******lwwwwwwwwnx**---*******-------------------T-T----**********---T-T-T-T-T-T-T-T
----M-M-------*******############################****lwwwwwwwwwr*************---B---------T-----------**********------------------
----M-M----**********####*****#######################eeeeeeeeeee#####********--------T---------T-T----**********---T-T-T-T-T-T-T-T
----M-A----*********####*---******************#######fffffffffff########*****-------------------------**********------------------
----M----***********####*-------------------*****####ggggggggggg###########****---LWWWWWWWWWWWRT-T----**********---T-T-T-T-T-T-T-T
----M----***********####*----------------------******lwwwwwwwwwnx***########***---T-----T-------------**********------------------
----M----***********####*------LWWWWWWWWWWWR------***lwwwwwwwwwwr*******####***----------------T-T----**********---T-T-T-T-T-T-T-T
----M-----**********####*-----U---T---T--------------lwwwwwwwwwwr********####**---B-------T-----------**********------------------
----M-----**********####*-----M----------------------yowwwwwwwpdz****---**####*--------S-------T-T----**********---T-T-T-T-T-T-T-T
----M--------*******####*-----M---LWWWWWWWWWWWWWWR---*yowwwwwpz******---**####**----------------------**********------------------
T---M--U-----*******####***---M--UB--------T----------------------------**####**-----LWWWWWWWWRT-T----**********---T-T-T-T-T-T-T-T
----M--M--------****####***-T-M--M----------------------T---------B---****####****---B-------------------****---------------------
----M--M--U-----*****####**---M--M------------------------------------****####****--------B------T-------****------T-T-T-T-T-T-T-T
----M--M--M--------**####**---M--M----LWWWWWWWWWWWWWWWWWWWWWWWWWWR----****####****-----------------------****---------------------
----M--M--M--U-----**####**---M--M---U--------S------B----------------****####****--H-----------T---*****####---T-T-T-T-T-T-T-T-T-
----M--M--M--M-----**####**---MS-M---M-T-----------------S--B---------****####******-****-----------****#####---------------------
----M--M--M--M--U---*####**---M--M---M------T------S------------------*****####*****-****---------*****#####*---T-T-T-T-T-T-T-T-T-
----M--M--M--MT-M---*####**---M--M---M--------------------------------******####****--**----------**#######**---------------------
----M--M--M--M--M---*####**---M--M---M--S--LWWWWWWWWWWWWWWWWWWWR------*******####***********----***#######***---T-T-T-T-T-T-T-T-T-
----M--M--M--M--M---*####**---M--M---M----U------------------------------*****####**********--**########***-----------------------
-T--M--M--M--M--M---*####**---M--M---M----M---vuuuuuuuuuuuuuuuuuuux------******####********###########*****--T-T-T-T-T-T-T-T-T-T-T
----M--M--M--M--MT--*####**---M--M---M-S--M---lwwwwwwwwwwwwwwwwwwwnx--------****####################****--------------------------
----M--MT-M--M--M---*####**---M-SM---M----M--vmwwwwwwwwwwwwwwwwwwwwr--------*****##################*****-----T-T-T-T-T-T-T-T-T-T-T
----M--M--M--M--M---*####**---M--M---M----M--lwwwwwwwwwwwwwwwwwwwwwr--------******###########******-------------------------------
----M--M--M--M--M---**####**--M--M---M----M--lwwwwwwwwwwwwwwwwwwwwwnx---------****************------------T-T-T-T-T-T-T-T-T-T-T-T-
----M--M--M--M--M---**####**--M--M---M-B--M--lwwwwwwwwwwwwwwwwwwwwwwr---------**************--------------------------------------
----M--M--MT-M--M---**####**--M--M---M----M--lwwwwwwwwwwwwwwwwwwwwwwr---------**************--------------------------------------
----M--M--M--M--M---**####**--M--M---M----M--lwwwwwwwwwwwwwwwwwwwwwwr-------------------------------------------------------------
----M--M--M--M--M---**####**--M--M---M----M--lwwwwwwwwwwwwwwwwwwwwwwnuuuuuuuuuuuuuuuuuuuuuuuuuuuuuuuuuuuuuuuuuuuuuuuuuuuuuuuuuuuuu
T---M--M--M--M--M---**####**--M--M---M----M--ydowwwwwwwwwwwwwwwwwwwwwwwwwwwwwwwwwwwwwwwwwwwwwwwwwwwwwwwwwwwwwwwwwwwwwwwwwwwwwwwwww
----MT-M--M--M--M---**####**--M--M---MB---M----yowwwwwwwwwwwwwwwwwwwwwwwwwwwwwwwwwwwwwwwwwwwwwwwwwwwwwwwwwwwwwwwwwwwwwwwwwwwwwwwww
----M--M--M--M--A---**####**--A--A---M----M--U--lwwwwwwwwwwwwwwwwwwwwwwwwwwwwwwwwwwwwwwwwwwwwwwwwwwwwwwwwwwwwwwwwwwwwwwwwwwwwwwwww
----M--M--M--MT-T-T---****--T-T-T----M----M--M--lwwwwwwwwwwwwwwwwwwwwwwwwwwwwwwwwwwwwwwwwwwwwwwwwwwwwwwwwwwwwwwwwwwwwwwwwwwwwwwwww
----M--M--A--A--------****-----------A----M--M--lwwwwwwwwwwwwwwwwwwwwwwwwwwwwwwwwwwwwwwwwwwwwwwwwwwwwwwwwwwwwwwwwwwwwwwwwwwwwwwwww
----M--M--T-T-T-T-T---****--T-T-T-T-T-T---M--M--yddddddddddddddddddddddddddddddddddddddddddddddddddddddddddddddddddddddddddddddddd
----A--A--------------****----------------A--A------------------------------------------------------------------------------------
----T-T-T-T-T-T-------****----------T-T-T-T-T-T-T-T-T-T-T-T-T-T-T-T-T-T-T-T-T-T-T-T-T-T-T-T-T-T-T-T-T-T-T-T-T-T-T-T-T-T-T-T-T-T-T-
----------------------****--------------------------------------------------------------------------------------------------------
T-T-T-T-T-H-------******************----T-T-T-T-T-T-T-T-T-T-T-T-T-T-T-T-T-T-T-T-T-T-T-T-T-T-T-T-T-T-T-T-T-T-T-T-T-T-T-T-T-T-T-T-T-
-----------****---******************----------------------------------------------------------------------------------------------
T-T-T-T-T--****-************************--T-T-T-T-T-T-T-T-T-T-T-T-T-T-T-T-T-T-T-T-T-T-T-T-T-T-T-T-T-T-T-T-T-T-T-T-T-T-T-T-T-T-T-T-
------------**--************************------------------------------------------------------------------------------------------
T-T-T-T---******************************--T-T-T-T-T-T-T-T-T-T-T-T-T-T-T-T-T-T-T-T-T-T-T-T-T-T-T-T-T-T-T-T-T-T-T-T-T-T-T-T-T-T-T-T-
----------******************************------------------------------------------------------------------------------------------
T-T-T-T---******************************--T-T-T-T-T-T-T-T-T-T-T-T-T-T-T-T-T-T-T-T-T-T-T-T-T-T-T-T-T-T-T-T-T-T-T-T-T-T-T-T-T-T-T-T-
----------******************************------------------------------------------------------------------------------------------
T-T-T-T-T---****************************--T-T-T-T-T-T-T-T-T-T-T-T-T-T-T-T-T-T-T-T-T-T-T-T-T-T-T-T-T-T-T-T-T-T-T-T-T-T-T-T-T-T-T-T-
------------------**********************------------------------------------------------------------------------------------------
T-T-T-T-T-T-------------**************--T-T-T-T-T-T-T-T-T-T-T-T-T-T-T-T-T-T-T-T-T-T-T-T-T-T-T-T-T-T-T-T-T-T-T-T-T-T-T-T-T-T-T-T-T-
------------SSSSSS------**************--------------------------------------------------------------------------------------------
T-T-T-T-T-T-T-T-T-T-T-T---------******--T-T-T-T-T-T-T-T-T-T-T-T-T-T-T-T-T-T-T-T-T-T-T-T-T-T-T-T-T-T-T-T-T-T-T-T-T-T-T-T-T-T-T-T-T-
--------------------------------******--------------------------------------------------------------------------------------------
T-T-T-T-T-T-T-T-T-T-T-T-T-T-T---******--T-T-T-T-T-T-T-T-T-T-T-T-T-T-T-T-T-T-T-T-T-T-T-T-T-T-T-T-T-T-T-T-T-T-T-T-T-T-T-T-T-T-T-T-T-
--------------------------------******--------------------------------------------------------------------------------------------
T-T-T-T-T-T-T-T-T-T-T-T-T-T-T---******--T-T-T-T-T-T-T-T-T-T-T-T-T-T-T-T-T-T-T-T-T-T-T-T-T-T-T-------------------------------------
--------------------------------******--------------------------------------------------------------------------------------------
T-T-T-T-T-T-T-T-T-T-T-T-T-T-T---******--T-T-T-T-T-T-T-T-T-T-T-T-T-T-T-T-T-T-T-T-T-T-T-T-T-T-T-------------------------------------
--------------------------------******--------------------------------------------------------------------------------------------
T-T-T-T-T-T-T-T-T-T-T-T-T-T-T---******--------------------------T-T-T-T-T-T-T-T-T-T-T-T-T-T-T-------------------------------------
--------------------------------******--------------------------------------------------------------------------------------------
T-T-T-T-T-T-T-T-T-T-T-T-T-T---**********************************--T-T-T-T-T-T-T-T-T-T-T-T-T-T-------------------------------------
------------------------------**********************************------------------------------------------------------------------
T-T-T-T-T-T-T-T-T-T-T-T-T-T---**********************************--T-T-T-T-T-T-T-T-T-T-T-T-T-T-------------------------------------
------------------------------**********************************------------------------------------------------------------------
T-T-T-T-T-T-T-T-T-T-T-T-T-T---**********************************--T-T-T-T-T-T-T-T-T-T-T-T-T-T-------------------------------------
------------------------------**********************************------------------------------------------------------------------
T-T-T-T-T-T-T-T-T-T-T-T-T-T---**********************************--T-T-T-T-T-T-T-T-T-T-T-T-T-T-------------------------------------
------------------------------**********************************------------------------------------------------------------------
T-T-T-T-T-T-T-T-T-T-T-T-T-T---**********************************--T-T-T-T-T-T-T-T-T-T-T-T-T-T-------------------------------------
------------------------------**********************************------------------------------------------------------------------
T-T-T-T-T-T-T-T-T-T-T-T-T-T---**********************************--T-T-T-T-T-T-T-T-T-T-T-T-T-T-------------------------------------
------------------------------**********************************------------------------------------------------------------------
T-T-T-T-T-T-T-T-T-T-T-T-T-T-T---------------------------******--T-T-T-T-T-T-T-T-T-T-T-T-T-T-T-------------------------------------
--------------------------------------------------------******--------------------------------------------------------------------
T-T-T-T-T-T-T-T-T-T-T-T-T-T-T-T-T-T-T-T-T-T-T-T-T-T-T-T---****--T-T-T-T-T-T-T-T-T-T-T-T-T-T-T-------------------------------------
----------------------------------------------------------****--------------------------------------------------------------------
T-T-T-T-T-T-T-T-T-T-T-T-T-T-T-T-T-T-T-T-T-T-T-T-T-T-T-T---****--T-T-T-T-T-T-T-T-T-T-T-T-T-T-T-------------------------------------
----------------------------------------------------------****--------------------------------------------------------------------
T-T-T-T-T-T-T-T-T-T-T-T-T-T-T-T-T-T-T-T-T-T-T-T-T-T-T-T---****--T-T-T-T-T-T-T-T-T-T-T-T-T-T-T-------------------------------------
----------------------------------------------------------****--------------------------------------------------------------------
T-T-T-T-T-T-T-T-T-T-T-T-T-T-T-T-T-T-T-T-T-T-T-T-T-T-T---********--T-T-T-T-T-T-T-T-T-T-T-T-T-T-------------------------------------
--------------------------------------------------------********------------------------------------------------------------------
T-T-T-T-T-T-T-T-T-T-T-T-T-T-T-T-T-T-T-T-T-T-T-T-T-T---************--T-T-T-T-T-T-T-T-T-T-T-T-T-------------------------------------
------------------------------------------------------************----------------------------------------------------------------
T-T-T-T-T-T-T-T-T-T-T-T-T-T-T-T-T-T-T-T-T-T-T-T-T---****************--T-T-T-T-T-T-T-T-T-T-T-T-------------------------------------
----------------------------------------------------****************--------------------------------------------------------------
T-T-T-T-T-T-T-T-T-T-T-T-T-T-T-T-T-T-T-T-T-T-T-T-T---****************--T-T-T-T-T-T-T-T-T-T-T-T-------------------------------------
----------------------------------------------------****************--------------------------------------------------------------
T-T-T-T-T-T-T-T-T-T-T-T-T-T-T-T-T-T-T-T-T-T-T-T-T---****************--T-T-T-T-T-T-T-T-T-T-T-T-------------------------------------
----------------------------------------------------****************--------------------------------------------------------------
T-T-T-T-T-T-T-T-T-T-T-T-T-T-T-T-T-T-T-T-T-T-T-T-T---****************--T-T-T-T-T-T-T-T-T-T-T-T-------------------------------------
----------------------------------------------------****************--------------------------------------------------------------
T-T-T-T-T-T-T-T-T-T-T-T-T-T-T-T-T-T-T-T-T-T-T-T-T-T---************--T-T-T-T-T-T-T-T-T-T-T-T-T-------------------------------------
------------------------------------------------------************----------------------------------------------------------------
T-T-T-T-T-T-T-T-T-T-T-T-T-T-T-T-T-T-T-T-T-T-T-T-T-T-T---********--T-T-T-T-T-T-T-T-T-T-T-T-T-T-------------------------------------
--------------------------------------------------------********------------------------------------------------------------------
T-T-T-T-T-T-T-T-T-T-T-T-T-T-T-T-T-T-T-T-T-T-T-T-T-T-T-T---****--T-T-T-T-T-T-T-T-T-T-T-T-T-T-T-------------------------------------
----------------------------------------------------------****--------------------------------------------------------------------
T-T-T-T-T-T-T-T-T-T-T-T-T-T-T-T-T-T-T-T-T-T-T-T-T-T-T-T---****--T-T-T-T-T-T-T-T-T-T-T-T-T-T-T-------------------------------------
----------------------------------------------------------****--------------------------------------------------------------------
T-T-T-T-T-T-T-T-T-T-T-T-T-T-T-T-T-T-T-T-T-T-T-T-T-T-T-T---****--T-T-T-T-T-T-T-T-T-T-T-T-T-T-T-------------------------------------
----------------------------------------------------------****--------------------------------------------------------------------
T-T-T-T-T-T-T-T-T-T-T-T-T-T-T-T-T-T-T-T-T-T-T-T-T-T-T-T---****--T-T-T-T-T-T-T-T-T-T-T-T-T-T-T-------------------------------------
----------------------------------------------------------****--------------------------------------------------------------------
T-T-T-T-T-T-T-T-T-T-T-T-T-T-T-T-T-T-T-T-T-T-T-T-T-T-T-T---****--T-T-T-T-T-T-T-T-T-T-T-T-T-T-T-------------------------------------
----------------------------------------------------------****--------------------------------------------------------------------
T-T-T-T-T-T-T-T-T-T-T-T-T-T-T-T-T-T-T-T-T-T-T-T-T-T-T-T---****--T-T-T-T-T-T-T-T-T-T-T-T-T-T-T-------------------------------------
----------------------------------------------------------****--------------------------------------------------------------------
T-T-T-T-T-T-T-T-T-T-T-T-T-T-T-T-T-T-T-T-T-T-T-T-T-T-T-T---****--T-T-T-T-T-T-T-T-T-T-T-T-T-T-T-------------------------------------
----------------------------------------------------------****--------------------------------------------------------------------
T-T-T-T-T-T-T-T-T-T-T-T-T-T-T-T-T-T-T-T-T-T-T-T-T-T-T-T---****--T-T-T-T-T-T-T-T-T-T-T-T-T-T-T-------------------------------------
----------------------------------------------------------****--------------------------------------------------------------------
T-T-T-T-T-T-T-T-T-T-T-T-T-T-T-T-T-T-T-T-T-T-T-T-T-T-T-T---****--T-T-T-T-T-T-T-T-T-T-T-T-T-T-T-------------------------------------
----------------------------------------------------------****--------------------------------------------------------------------
T-T-T-T-T-T-T-T-T-T-T-T-T-T-T-T-T-T-T-T-T-T-T-T-T-T-T-T---****--T-T-T-T-T-T-T-T-T-T-T-T-T-T-T-------------------------------------
----------------------------------------------------------****--------------------------------------------------------------------
T-T-T-T-T-T-T-T-T-T-T-T-T-T-T-T-T-T-T-T-T-T-T-T-T-T-T-T---****--T-T-T-T-T-T-T-T-T-T-T-T-T-T-T-------------------------------------
----------------------------------------------------------****--------------------------------------------------------------------
T-T-T-T-T-T-T-T-T-T-T-T-T-T-T-T-T-T-T-T-T-T-T-T-T-T-------****--T-T-T-T-T-T-T-T-T-T-T-T-T-T-T-------------------------------------
----------------------------------------------------------****--------------------------------------------------------------------
T-T-T-T-T-T-T-T-T-T-T-T-T-T-T-T-T-T-T-T-T-T-T-T-T---****************--T-T-T-T-T-T-T-T-T-T-T-T-------------------------------------
----------------------------------------------------****************--------------------------------------------------------------
--------------------------------------------------********************--T-T-T-T-T-T-T-T-T-T-T-------------------------------------
--------------------------------------------------********************------------------------------------------------------------
**********************************************************************--T-T-T-T-T-T-T-T-T-T-T-------------------------------------
**********************************************************************------------------------------------------------------------
**********************************************************************--T-T-T-T-T-T-T-T-T-T-T-------------------------------------
**********************************************************************------------------------------------------------------------
----------------------------------------------------------------------T-T-T-T-T-T-T-T-T-T-T-T-------------------------------------
----------------------------------------------------------------------------------------------------------------------------------
T-T-T-T-T-T-T-T-T-T-T-T-T-T-T-T-T-T-T-T-T-T-T-T-T-T-T-T-T-T-T-T-T-T-T-T-T-T-T-T-T-T-T-T-T-T-T-------------------------------------
----------------------------------------------------------------------------------------------------------------------------------