---------------------------------------------------------------------------------------------------Q------------------------------
----------------------------------------------------------------------------------------------------------------------------------
-----------------------------------------------U----------------------------------------------------------------------------------
---------------U-------------------------------B--B--*wwwwwwww*B--U-----------------------------------****Z-****------------------
--------------B--**************U---------------------*wwwwwwww*---B--T-*****B-------------------------****--****------------------
-----------B-----******************************------*wwwwwwww*--------*****--------------------------****kb****------------------
-----------------**C-*********8***********************wwwwwwww****---*******--------------------------**********------------------
--------B-----*****--*********************************wwwwwwwww****g*********B------------------------**s****s**------------------
-----------******************************************************************-------------------------**********------------------
-----------****GG********B--*************************************s**a********-------------------------**s****s**------------------
------B--***G*agg********---U---------------***********************************B----------------------**********------------------
---------**G***g*********-------------------B--*******wwwwwwwww****g***********-----------------------**********------------------
---------*****G**********T-L-------------------B--****wwwwwwwwww***************-----------------------**********------------------
-------B--*******C-******-------------------------B--*wwwwwwwwww***************T----------------------**********------------------
----------*******--******T---------------------------**wwwwwww*******B--*******-----------------------**********------------------
----------B--************----------------------------***wwwww********---********T---------------------**********------------------
-------------**************--------------------------U------------------********--B-------------------***}~~~***------------------
-------------B--***********------------------------------------------L************-----------------------~~~~---------------------
----------------***********-------------------------------------------************-----------------------~~~~---------------------
----------------B--********-------------------------------------------************T----------B-----------~~~~---------------------
-------------------********-------------------------------------------***S****S***--H-------------T-*********B--------------------
-------------------********-------------------------------------------**************-**u*-B---------*********---------------------
-------------------L*******-L-----------------------------------------**************-****-------T-***********---------------------
--------------------*******-------------------------------------------**********S***--**------T---***********B--------------------
--------------------*******-------------------------------------------******S********c**c***T---S************---------------------
--------------------*******-------------------------------------------B--*************8*****--*************T----------------------
--------------------*******----------------------------------------------*****g******S**S******************-----------------------
--------------------*******----------------------------------------------B--****************************T-B-----------------------
--------------------******T-------------------------------------------------****c*****g*****************--------------------------
--------------------******--------------------------------------------------**********************ST-T-B--------------------------
--------------------********-----------------------------------------------B--***c***S**S*****T-T---------------------------------
--------------------********--------------------------------------------------****8*********T-------------------------------------
--------------------********--------------------------------------------------**************--------------------------------------
--------------------********------------------------------------------U---------------U-------------------------------------------
--------------------********------------------------------------------------------------------------------------------------------
--------------------********------------------------------------------------------------------------------------------------------
--------------------********------------------------------------------------------------------------------------------------------
--------------------********------------------------------------------------------------------------------------------------------
--------------------T-****T-------------------------------------------------------------------------------------------------------
----------------------****--------------------------------------------------------------------------------------------------------
--------------------T-****T-------------------------------------------------------------------------------------------------------
----------------------{~~~--------------------------------------------------------------------------------------------------------
----------------T-T-T-~~~~T-T-T-T-T-----------------------------------------------------------------------------------------------
----------------------~~~~--------------------------------------------------------------------------------------------------------
----------H-----T-******************T-T-------------------------------------------------------------------------------------------
-----------u***---******************----------------------------------------------------------------------------------------------
-----------****-***g***b******g*********T-----------------------------------------------------------------------------------------
------------**--*****a***********C-*****------------------------------------------------------------------------------------------
--------T-SG**GS**********S******--*****T-----------------------------------------------------------------------------------------
----------******************************------------------------------------------------------------------------------------------
--------T-************C-****************T-----------------------------------------------------------------------------------------
----------************--******T-********------------------------------------------------------------------------------------------
----------T-******************--********T-----------------------------------------------------------------------------------------
------------T-T-T-**********************------------------------------------------------------------------------------------------
------------------T-T-T-**********g***T-------------------------------------------------------------------------------------------
------------------------**************--------------------------------------------------------------------------------------------
------------------------T-T-T-T-******T-------------------------------------------------------------------------------------------
--------------------------------******--------------------------------------------------------------------------------------------
------------------------------T-******T-------------------------------------------------------------------------------------------
--------------------------------******--------------------------------------------------------------------------------------------
------------------------------T-******T-------------------------------------------------------------------------------------------
--------------------------------******--------------------------------------------------------------------------------------------
------------------------------T-******T-------------------------------------------------------------------------------------------
--------------------------------******--------------------------------------------------------------------------------------------
------------------------------T-******T-T-T-T-T-T-T-T-T-T-T-T-T-------------------------------------------------------------------
--------------------------------******--------------------------------------------------------------------------------------------
----------------------------T-*****g****************************T-----------------------------------------------------------------
------------------------------*************************#********------------------------------------------------------------------
----------------------------T-**S******C-*****c**S*****c******S*T-----------------------------------------------------------------
------------------------------*********--**S********************------------------------------------------------------------------
----------------------------T-****C-********************C-******T-----------------------------------------------------------------
------------------------------****--****c8****C-********--******------------------------------------------------------------------
----------------------------T-*#c*************--*************C-*T-----------------------------------------------------------------
------------------------------***********C-*****c#**S********--*------------------------------------------------------------------
----------------------------T-**C-**S****--*********************T-----------------------------------------------------------------
------------------------------**--**************S***********c***------------------------------------------------------------------
----------------------------T-*********#c***********************T-----------------------------------------------------------------
------------------------------**********************************------------------------------------------------------------------
------------------------------T-T-T-T-T-T-T-T-T-T-T-T-T-******T-------------------------------------------------------------------
--------------------------------------------------------******--------------------------------------------------------------------
--------------------------------------------------------T-****T-------------------------------------------------------------------
----------------------------------------------------------****--------------------------------------------------------------------
--------------------------------------------------------T-****T-------------------------------------------------------------------
----------------------------------------------------------****--------------------------------------------------------------------
--------------------------------------------------------T-****T-------------------------------------------------------------------
----------------------------------------------------------****--------------------------------------------------------------------
------------------------------------------------------T-********T-----------------------------------------------------------------
--------------------------------------------------------********------------------------------------------------------------------
----------------------------------------------------T-************T---------------------------------------------------------------
------------------------------------------------------************----------------------------------------------------------------
--------------------------------------------------T-****************T-------------------------------------------------------------
----------------------------------------------------****************--------------------------------------------------------------
--------------------------------------------------T-****c******c****T-------------------------------------------------------------
----------------------------------------------------****#**C-**#****--------------------------------------------------------------
--------------------------------------------------T-*******--*******T-------------------------------------------------------------
----------------------------------------------------****************--------------------------------------------------------------
--------------------------------------------------T-****************T-------------------------------------------------------------
----------------------------------------------------****************--------------------------------------------------------------
----------------------------------------------------T-************T---------------------------------------------------------------
------------------------------------------------------************----------------------------------------------------------------
------------------------------------------------------T-********T-----------------------------------------------------------------
--------------------------------------------------------********------------------------------------------------------------------
--------------------------------------------------------T-****T-------------------------------------------------------------------
----------------------------------------------------------****--------------------------------------------------------------------
--------------------------------------------------------T-****T-------------------------------------------------------------------
----------------------------------------------------------****--------------------------------------------------------------------
--------------------------------------------------------T-****T-------------------------------------------------------------------
----------------------------------------------------------****--------------------------------------------------------------------
--------------------------------------------------------T-****T-------------------------------------------------------------------
----------------------------------------------------------****--------------------------------------------------------------------
--------------------------------------------------------T-****T-------------------------------------------------------------------
----------------------------------------------------------****--------------------------------------------------------------------
--------------------------------------------------------T-****T-------------------------------------------------------------------
----------------------------------------------------------****--------------------------------------------------------------------
--------------------------------------------------------T-****T-------------------------------------------------------------------
----------------------------------------------------------****--------------------------------------------------------------------
--------------------------------------------------------T-****T-------------------------------------------------------------------
----------------------------------------------------------****--------------------------------------------------------------------
--------------------------------------------------------T-****T-------------------------------------------------------------------
----------------------------------------------------------****--------------------------------------------------------------------
--------------------------------------------------------T-****T-------------------------------------------------------------------
----------------------------------------------------------****--------------------------------------------------------------------
--------------------------------------------------------T-****T-------------------------------------------------------------------
----------------------------------------------------------|~~~--------------------------------------------------------------------
----------------------------------------------------T-T-T-~~~~T-T-T---------------------------------------------------------------
----------------------------------------------------------~~~~--------------------------------------------------------------------
--------------------------------------------------T-****************T-------------------------------------------------------------
----------------------------------------------------**********?*****--------------------------------------------------------------
T-T-T-T-T-T-T-T-T-T-T-T-T-T-T-T-T-T-T-T-T-T-T-T-T-********************T-----------------------------------------------------------
--------------------------------------------------********************------------------------------------------------------------
**********************************************************************T-----------------------------------------------------------
*******************************************************G**G**G**G*****------------------------------------------------------------
**p*******************************************************************T-----------------------------------------------------------
**********************************************************************------------------------------------------------------------
T-T-T-T-T-T-T-T-T-T-T-T-T-T-T-T-T-T-T-T-T-T-T-T-T-T-T-T-T-T-T-T-T-T-T-------------------------------------------------------------
----------------------------------------------------------------------------------------------------------------------------------
----------------------------------------------------------------------------------------------------------------------------------
----------------------------------------------------------------------------------------------------------------------------------